0000000000000000000000000
0000000000000000000000000
0000001111100000000000006
0000000000010000000000001
1000000000001000000000001
0000000000000111111000001
0000000000000000000000001
0001000000100000000000001
0001000000100000000000001
0001000000100000000000001
1111111111111100000000001
1100000000001110000000001
1120000000031111000000001
1110000000011111110000001
1111100000111000000000001
0000000000000000000900001
0000001110000000000900011
1111111111111111111111111