1111111100000000000000000
0000000100000000000000000
0000000100000000011111116
1111000910000000010000011
1000000001100000010000010
0000000000000000010000010
0000000100000000000000010
0000000100000110000000010
0000000100000000000000010
0003000111000000000000010
0011111100000000000000010
0000000000000001000110010
0000000000001111000001010
0000000000011001000000010
0000000000110001000000010
0000000009900001000000110
0000000019002001000000110
1111111111111111111111111