1111111100000000000000000
0000000100000000000000000
0300000100000000011111116
1111000910000000010000011
1000000001100000010000010
0000000000000000010000010
0000000100000000090000010
0000000100000110090000010
0000000100000000090000010
0000000111000000090000010
0011111100000000090000010
0000000000000001090110010
0000000000001111090001010
0000000000011001090000010
0000000000110001090000010
0000000009900001090000110
0000000019002001090000110
1111111111111111111111111