1111111100000000000000000 
0000000100000000000000000
0000000100000000011111110
1111000110000000010000010
1000000001100000010000010
0000000000000000010000010
0000000100000000000000010
0000000100000110000000010
0000000100000000000000010
0000000111000000000000010
0111111100000000000000010
0000000000000001000110010
0000000000001110000001010
0000000000010000000000010
0000000000100000000000010
0000000001000000000000110 
0000000010000000000000110
1111111111111111111111111