0000000000000000000000000000000000000000000
0000000000000000000000000000000000000000000
0000000000000000000000000000000000000000000
0000000000000000000000000000000000000000000
0000000000000000000000000000000000000000000
0000000000000000000000000000000000000000000
0000000000000000000000000000000000000000000
0000000000000000000000000000000000000000000
0000000000000000000000000000000000000000000
0000000000000000000000000000000000000000000
0000000000000000000000000000000000000000000
0000000000000000000000000000000000000000000
0000000000000000000000000000000000000000000
0000000000000600000000000000000000000000000
0000000000000000000000000200000030000000000
1111111111111111111111111111111111111110000
0000000000000000000000000000000000000001000
0000000000000000000000000000000000000000000
0000000000000000000000000000000000000000000
0000000000000000000000000000000000000000010
0000000000000000000000000000000000000000111
0000000000000000010000000000000100000011111
0000000001110000011001111100000100000000111
1111111111110001111000110000011100111000000
1111111111100001111000111000011100011000000
1111111111100001111000111000001000011000000